111111111111
100000000001
1P0000000001
100000C0000E
111111111111