111111111111
100000000001
1P0000000001
1000C0C000E1
111111111111
