1111111
1000P01
100E001
1000C01
1111111