1111111
1000C01
1000001

1000001
1111111