111111111111
100000C00001
1P00000000C1
100000C000E1
111111111111